NO textures/lava.xpm
SO textures/lava.xpm
WE textures/lava.xpm
EA textures/lava.xpm

F 126,42,28
C 255,106,19

        1111111111111111111111111
        1000000000000000000000001
        1100000000000000000000001
        1000000000000000000000001
111111111000000000000000000000001
100000000000000000000000000011111
1000000000000010000000000001
10000000000000000000000000001
10000000000W00000000000000001
10000000000000000000000000001
10000000000000000001010000001
11000001110101011111011110101
11110111 1110111 101111010001
11111111 1111111 111111111111