NO textures/simonkraft/cyan_concrete.xpm
SO textures/simonkraft/cyan_concrete.xpm
WE textures/simonkraft/warped_planks.xpm
EA textures/simonkraft/warped_planks.xpm

F 0,139,139
C 173,216,230

11111111111111111111111111111
10000000001100000000000000001
10110000001100000000000000001
10010000000000000000000000001
10110000001100000000000000001
10000000001100000111011110001
11110111111111011110000000101
11110111111111011110101000101
11000000110101110100000000001
10000000000000001100000000001
10000000000000001100010000001
11000000110101110000000000001
11110111111101110000000100001
10000000001100001000000000101
10000000000000000000000000101
10000000000100001000000100101
100W0000110101100000000000101
10000000000100000000000000001
11111111111111111111111111111
