NO textures/simonkraft/crystal.xpm
SO textures/simonkraft/crystal_imac.xpm
WE textures/simonkraft/crystal_box.xpm
EA textures/simonkraft/crystal_sign.xpm

F 47,86,118
C 102,175,210

111111111111111
100000000000001
100S001111111111111111
1000001000000000000001
1000000000000000000001
1000001000000000000001
1111111111111111111111