NO textures/simonkraft/crystal.xpm
SO textures/simonkraft/crystal_imac.xpm
WE textures/simonkraft/crystal_box.xpm
EA textures/simonkraft/crystal_sign.xpm

F 47,86,118
C 102,175,210

11111111111
1000N000001
10000000001
10001010001
11111 11111