NO textures/simonkraft/crystal.xpm
SO textures/simonkraft/crystal_imac.xpm
WE textures/simonkraft/crystal_box.xpm
EA textures/simonkraft/crystal_sign.xpm

F 47,86,118
C 102,175,210

11 111111
1000N0001
111111111