111111111111111111
100000000000000001
100010000000000001
100000000000000001
100000000010000001
100000000000000001
100000000000000001
100000000000000001
100000100000000001
111111111111111111